[xx][yy]_[dot][tpaper][vac][cov]_[u][d][l][r] 17*19
0101_0000_0101
0201_0000_0011
0301_0000_0011
0401_0000_0111
0501_0000_0011
0601_0000_0011
0701_0000_0011
0801_0000_0110
0901_0000_0000
1001_0000_0101
1101_0000_0011
1201_0000_0011
1301_0000_0011
1401_0000_0111
1501_0000_0011
1601_0000_0011
1701_0000_0110
0102_0000_1100
0202_0000_0000
0302_0000_0000
0402_0000_1100
0502_0000_0000
0602_0000_0000
0702_0000_0000
0802_0000_1100
0902_0000_0000
1002_0000_1100
1102_0000_0000
1202_0000_0000
1302_0000_0000
1402_0000_1100
1502_0000_0000
1602_0000_0000
1702_0000_1100
0103_0000_1100
0203_0000_0000
0303_0000_0000
0403_0000_1100
0503_0000_0000
0603_0000_0000
0703_0000_0000
0803_0000_1100
0903_0000_0000
1003_0000_1100
1103_0000_0000
1203_0000_0000
1303_0000_0000
1403_0000_1100
1503_0000_0000
1603_0000_0000
1703_0000_1100
0104_0000_1101
0204_0000_0011
0304_0000_0011
0404_0000_1111
0504_0000_0011
0604_0000_0111
0704_0000_0011
0804_0000_1011
0904_0000_0011
1004_0000_1011
1104_0000_0011
1204_0000_0111
1304_0000_0011
1404_0000_1111
1504_0000_0011
1604_0000_0011
1704_0000_1110
0105_0000_1100
0205_0000_0000
0305_0000_0000
0405_0000_1100
0505_0000_0000
0605_0000_1100
0705_0000_0000
0805_0000_0000
0905_0000_0000
1005_0000_0000
1105_0000_0000
1205_0000_1100
1305_0000_0000
1405_0000_1100
1505_0000_0000
1605_0000_0000
1705_0000_1100
0106_0000_1001
0206_0000_0011
0306_0000_0011
0406_0000_1110
0506_0000_0000
0606_0000_1001
0706_0000_0011
0806_0000_0110
0906_0000_0000
1006_0000_0101
1106_0000_0011
1206_0000_1010
1306_0000_0000
1406_0000_1101
1506_0000_0011
1606_0000_0011
1706_0000_1010
0107_0000_0000
0207_0000_0000
0307_0000_0000
0407_0000_1100
0507_0000_0000
0607_0000_0000
0707_0000_0000
0807_0000_1100
0907_0000_0000
1007_0000_1100
1107_0000_0000
1207_0000_0000
1307_0000_0000
1407_0000_1100
1507_0000_0000
1607_0000_0000
1707_0000_0000
1807_0000_0000
0108_0000_0000
0208_0000_0000
0308_0000_0000
0408_0000_1100
0508_0000_0000
0608_0000_0101
0708_0000_0011
0808_0000_1011
0908_0000_0011
1008_0000_1011
1108_0000_0011
1208_0000_0110
1308_0000_0000
1408_0000_1100
1508_0000_0000
1608_0000_0000
1708_0000_0000
0109_0000_0000
0209_0000_0000
0309_0000_0000
0409_0000_1100
0509_0000_0000
0609_0000_1100
0709_0000_0000
0809_0000_0000
0909_0000_0000
1009_0000_0000
1109_0000_0000
1209_0000_1100
1309_0000_0000
1409_0000_1100
1509_0000_0000
1609_0000_0000
1709_0000_0000
0110_0000_0000
0210_0000_0000
0310_0000_0000 !!!
0410_0000_1111
0510_0000_0011
0610_0000_1110
0710_0000_0000
0810_0000_0000
0910_0000_0000
1010_0000_0000
1110_0000_0000
1210_0000_1101
1310_0000_1100
1410_0000_1111
1510_0000_0000 !!!
1610_0000_0000
1710_0000_0000
0111_0000_0000
0211_0000_0000
0311_0000_0000
0411_0000_1100
0511_0000_0000
0611_0000_1100
0711_0000_0000
0811_0000_0000
0911_0000_0000
1011_0000_0000
1111_0000_0000
1211_0000_1100
1311_0000_0000
1411_0000_1100
1511_0000_0000
1611_0000_0000
1711_0000_0000
0112_0000_0000
0212_0000_0000
0312_0000_0000
0412_0000_1100
0512_0000_0000
0612_0000_1101
0712_0000_0011
0812_0000_0011
0912_0000_0011
1012_0000_0011
1112_0000_0011
1212_0000_1110
1312_0000_0000
1412_0000_1100
1512_0000_0000
1612_0000_0000
1712_0000_0000
0113_0000_0000
0213_0000_0000
0313_0000_0000
0413_0000_1100
0513_0000_0000
0613_0000_1100
0713_0000_0000
0813_0000_0000
0913_0000_0000
1013_0000_0000
1113_0000_0000
1213_0000_1100
1313_0000_0000
1413_0000_1100
1513_0000_0000
1613_0000_0000
1713_0000_0000
0114_0000_0101
0214_0000_0011
0314_0000_0011
0414_0000_1111
0514_0000_0011
0614_0000_1011
0714_0000_0011
0814_0000_0110
0914_0000_0000
1014_0000_0101
1114_0000_0011
1214_0000_1011
1314_0000_0011
1414_0000_1111
1514_0000_0011
1614_0000_0011
1714_0000_0110
0115_0000_1100
0215_0000_0000
0315_0000_0000
0415_0000_0000
0515_0000_0000
0615_0000_0000
0715_0000_0000
0815_0000_0000
0915_0000_0000
1015_0000_0000
1115_0000_0000
1215_0000_0000
1315_0000_0000
1415_0000_0000
1515_0000_0000
1615_0000_0000
1715_0000_0000
0116_0000_0000
0216_0000_0000
0316_0000_0000
0416_0000_0000
0516_0000_0000
0616_0000_0000
0716_0000_0000
0816_0000_0000
0916_0000_0000
1016_0000_0000
1116_0000_0000
1216_0000_0000
1316_0000_0000
1416_0000_0000
1516_0000_0000
1616_0000_0000
1716_0000_0000
0117_0000_0000
0217_0000_0000
0317_0000_0000
0417_0000_0000
0517_0000_0000
0617_0000_0000
0817_0000_0000
0917_0000_0000
1017_0000_0000
1117_0000_0000
1217_0000_0000
1317_0000_0000
1417_0000_0000
1517_0000_0000
1617_0000_0000
1717_0000_0000
0118_0000_0000
0218_0000_0000
0318_0000_0000
0418_0000_0000
0518_0000_0000
0618_0000_0000
0718_0000_0000
0818_0000_0000
0918_0000_0000
1018_0000_0000
1118_0000_0000
1218_0000_0000
1318_0000_0000
1418_0000_0000
1518_0000_0000
1618_0000_0000
1718_0000_0000
0119_0000_0000
0219_0000_0000
0319_0000_0000
0419_0000_0000
0519_0000_0000
0619_0000_0000
0719_0000_0000
0819_0000_0000
0919_0000_0000
1019_0000_0000
1119_0000_0000
1219_0000_0000
1319_0000_0000
1419_0000_0000
1519_0000_0000
1619_0000_0000
1719_0000_0000