[xx][yy]_[dot][tpaper][vac][cov]_[u][d][l][r] 17*19
0101_0000_0101
0201_0000_0011
0301_0000_0011
0401_0000_0111
0501_0000_0011
0601_0000_0011
0701_0000_0011
0801_0000_0110
0901_0000_0000
1001_0000_0101
1101_0000_0011
1201_0000_
1301_0000_
1401_0000_
1501_0000_
1601_0000_
1701_0000_
0102_0000_
0202_0000_
0302_0000_
0402_0000_
0502_0000_
0602_0000_
0702_0000_
0802_0000_
0902_0000_
1002_0000_
1102_0000_
1202_0000_
1302_0000_
1402_0000_
1502_0000_
1602_0000_
1702_0000_
0103_0000_
0203_0000_
0303_0000_
0403_0000_
0503_0000_
0603_0000_
0703_0000_
0803_0000_
0903_0000_
1003_0000_
1103_0000_
1203_0000_
1303_0000_
1403_0000_
1503_0000_
1603_0000_
1703_0000_
0104_0000_
0204_0000_
0304_0000_
0404_0000_
0504_0000_
0604_0000_
0704_0000_
0804_0000_
0904_0000_
1004_0000_
1104_0000_
1204_0000_
1304_0000_
1404_0000_
1504_0000_
1604_0000_
1704_0000_
0105_0000_
0205_0000_
0305_0000_
0405_0000_
0505_0000_
0605_0000_
0705_0000_
0805_0000_
0905_0000_
1005_0000_
1105_0000_
1205_0000_
1305_0000_
1405_0000_
1505_0000_
1605_0000_
1705_0000_
0106_0000_
0206_0000_
0306_0000_
0406_0000_
0506_0000_
0606_0000_
0706_0000_
0806_0000_
0906_0000_
1006_0000_
1106_0000_
1206_0000_
1306_0000_
1406_0000_
1506_0000_
1606_0000_
1706_0000_
0107_0000_
0207_0000_
0307_0000_
0407_0000_
0507_0000_
0607_0000_
0707_0000_
0807_0000_
0907_0000_
1007_0000_
1107_0000_
1207_0000_
1307_0000_
1407_0000_
1507_0000_
1607_0000_
1707_0000_
1807_0000_
0108_0000_
0208_0000_
0308_0000_
0408_0000_
0508_0000_
0608_0000_
0708_0000_
0808_0000_
0908_0000_
1008_0000_
1108_0000_
1208_0000_
1308_0000_
1408_0000_
1508_0000_
1608_0000_
1708_0000_
0109_0000_
0209_0000_
0309_0000_
0409_0000_
0509_0000_
0609_0000_
0709_0000_
0809_0000_
0909_0000_
1009_0000_
1109_0000_
1209_0000_
1309_0000_
1409_0000_
1509_0000_
1609_0000_
1709_0000_
0110_0000_
0210_0000_
0310_0000_
0410_0000_
0510_0000_
0610_0000_
0710_0000_
0810_0000_
0910_0000_
1010_0000_
1110_0000_
1210_0000_
1310_0000_
1410_0000_
1510_0000_
1610_0000_
1710_0000_
0111_0000_
0211_0000_
0311_0000_
0411_0000_
0511_0000_
0611_0000_
0711_0000_
0811_0000_
0911_0000_
1011_0000_
1111_0000_
1211_0000_
1311_0000_
1411_0000_
1511_0000_
1611_0000_
1711_0000_
0112_0000_
0212_0000_
0312_0000_
0412_0000_
0512_0000_
0612_0000_
0712_0000_
0812_0000_
0912_0000_
1012_0000_
1112_0000_
1212_0000_
1312_0000_
1412_0000_
1512_0000_
1612_0000_
1712_0000_
0113_0000_
0213_0000_
0313_0000_
0413_0000_
0513_0000_
0613_0000_
0713_0000_
0813_0000_
0913_0000_
1013_0000_
1113_0000_
1213_0000_
1313_0000_
1413_0000_
1513_0000_
1613_0000_
1713_0000_
0114_0000_
0214_0000_
0314_0000_
0414_0000_
0514_0000_
0614_0000_
0714_0000_
0814_0000_
0914_0000_
1014_0000_
1114_0000_
1214_0000_
1314_0000_
1414_0000_
1514_0000_
1614_0000_
1714_0000_
0115_0000_
0215_0000_
0315_0000_
0415_0000_
0515_0000_
0615_0000_
0715_0000_
0815_0000_
0915_0000_
1015_0000_
1115_0000_
1215_0000_
1315_0000_
1415_0000_
1515_0000_
1615_0000_
1715_0000_
0116_0000_
0216_0000_
0316_0000_
0416_0000_
0516_0000_
0616_0000_
0716_0000_
0816_0000_
0916_0000_
1016_0000_
1116_0000_
1216_0000_
1316_0000_
1416_0000_
1516_0000_
1616_0000_
1716_0000_
0117_0000_
0217_0000_
0317_0000_
0417_0000_
0517_0000_
0617_0000_
0817_0000_
0917_0000_
1017_0000_
1117_0000_
1217_0000_
1317_0000_
1417_0000_
1517_0000_
1617_0000_
1717_0000_
0118_0000_
0218_0000_
0318_0000_
0418_0000_
0518_0000_
0618_0000_
0718_0000_
0818_0000_
0918_0000_
1018_0000_
1118_0000_
1218_0000_
1318_0000_
1418_0000_
1518_0000_
1618_0000_
1718_0000_
0119_0000_
0219_0000_
0319_0000_
0419_0000_
0519_0000_
0619_0000_
0719_0000_
0819_0000_
0919_0000_
1019_0000_
1119_0000_
1219_0000_
1319_0000_
1419_0000_
1519_0000_
1619_0000_
1719_0000_
