[x][x][y][y]_[dot][tpaper][vac][cov]_[u][d][l][r] 17*20
0101_1000_0101
0201_1000_0011
0301_1000_0011
0401_1000_0111
0501_1000_0011
0601_1000_0011
0701_1000_0011
0801_1000_0110
0901_0000_0000
1001_1000_0101
1101_1000_0011
1201_1000_0011
1301_1000_0011
1401_1000_0111
1501_1000_0011
1601_1000_0011
1701_1000_0110
0102_1000_1100
0202_0000_0000
0302_0000_0000
0402_1000_1100
0502_0000_0000
0602_0000_0000
0702_0000_0000
0802_1000_1100
0902_0000_0000
1002_1000_1100
1102_0000_0000
1202_0000_0000
1302_0000_0000
1402_1000_1100
1502_0000_0000
1602_0000_0000
1702_1000_1100
0103_1000_1100
0203_0000_0000
0303_0000_0000
0403_1000_1100
0503_0000_0000
0603_0000_0000
0703_0000_0000
0803_1000_1100
0903_0000_0000
1003_1000_1100
1103_0000_0000
1203_0000_0000
1303_0000_0000
1403_1000_1100
1503_0000_0000
1603_0000_0000
1703_1000_1100
0104_1000_1101
0204_1000_0011
0304_1000_0011
0404_1000_1111
0504_1000_0011
0604_1000_0111
0704_1000_0011
0804_1000_1011
0904_1000_0011
1004_1000_1011
1104_1000_0011
1204_1000_0111
1304_1000_0011
1404_1000_1111
1504_1000_0011
1604_1000_0011
1704_1000_1110
0105_1000_1100
0205_0000_0000
0305_0000_0000
0405_1000_1100
0505_0000_0000
0605_1000_1100
0705_0000_0000
0805_0000_0000
0905_0000_0000
1005_0000_0000
1105_0000_0000
1205_1000_1100
1305_0000_0000
1405_1000_1100
1505_0000_0000
1605_0000_0000
1705_1000_1100
0106_1000_1001
0206_1000_0011
0306_1000_0011
0406_1000_1110
0506_0000_0000
0606_1000_1001
0706_1000_0011
0806_1000_0110
0906_0000_0000
1006_1000_0101
1106_1000_0011
1206_1000_1010
1306_0000_0000
1406_1000_1101
1506_1000_0011
1606_1000_0011
1706_1000_1010
0107_0000_0000
0207_0000_0000
0307_0000_0000
0407_1000_1100
0507_0000_0000
0607_0000_0000
0707_0000_0000
0807_1000_1100
0907_0000_0000
1007_1000_1100
1107_0000_0000
1207_0000_0000
1307_0000_0000
1407_1000_1100
1507_0000_0000
1607_0000_0000
1707_0000_0000
0108_0000_0000
0208_0000_0000
0308_0000_0000
0408_1000_1100
0508_0000_0000
0608_1000_0101
0708_1000_0011
0808_1000_1011
0908_1000_0011
1008_1000_1011
1108_1000_0011
1208_1000_0110
1308_0000_0000
1408_1000_1100
1508_0000_0000
1608_0000_0000
1708_0000_0000
0109_0000_0000
0209_0000_0000
0309_0000_0000
0409_1000_1100
0509_0000_0000
0609_1000_1100
0709_0000_0000
0809_0000_0000
0909_0000_0000
1009_0000_0000
1109_0000_0000
1209_1000_1100
1309_0000_0000
1409_1000_1100
1509_0000_0000
1609_0000_0000
1709_0000_0000
0110_0000_0000
0210_0000_0000
0310_0000_0000 !!!
0410_1000_1111
0510_1000_0011
0610_1000_1110
0710_0000_0000
0810_0000_0000
0910_0000_0000
1010_0000_0000
1110_0000_0000
1210_1000_1101
1310_1000_0011
1410_1000_1111
1510_0000_0000 !!!
1610_0000_0000
1710_0000_0000
0111_0000_0000
0211_0000_0000
0311_0000_0000
0411_1000_1100
0511_0000_0000
0611_1000_1100
0711_0000_0000
0811_0000_0000
0911_0000_0000
1011_0000_0000
1111_0000_0000
1211_1000_1100
1311_0000_0000
1411_1000_1100
1511_0000_0000
1611_0000_0000
1711_0000_0000
0112_0000_0000
0212_0000_0000
0312_0000_0000
0412_1000_1100
0512_0000_0000
0612_1000_1101
0712_1000_0011
0812_1000_0011
0912_1000_0011
1012_1000_0011
1112_1000_0011
1212_1000_1110
1312_0000_0000
1412_1000_1100
1512_0000_0000
1612_0000_0000
1712_0000_0000
0113_0000_0000
0213_0000_0000
0313_0000_0000
0413_1000_1100
0513_0000_0000
0613_1000_1100
0713_0000_0000
0813_0000_0000
0913_0000_0000
1013_0000_0000
1113_0000_0000
1213_1000_1100
1313_0000_0000
1413_1000_1100
1513_0000_0000
1613_0000_0000
1713_0000_0000
0114_1000_0101
0214_1000_0011
0314_1000_0011
0414_1000_1111
0514_1000_0011
0614_1000_1011
0714_1000_0011
0814_1000_0110
0914_0000_0000
1014_1000_0101
1114_1000_0011
1214_1000_1011
1314_1000_0011
1414_1000_1111
1514_1000_0011
1614_1000_0011
1714_1000_0110
0115_1000_1100
0215_0000_0000
0315_0000_0000
0415_1000_1100
0515_0000_0000
0615_0000_0000
0715_0000_0000
0815_1000_1100
0915_0000_0000
1015_1000_1100
1115_0000_0000
1215_0000_0000
1315_0000_0000
1415_1000_1100
1515_0000_0000
1615_0000_0000
1715_1000_1100
0116_1000_1101
0216_1000_0110
0316_0000_0000
0416_1000_1101
0516_1000_0011
0616_1000_0111
0716_1000_0011
0816_1000_1011
0916_1000_0011
1016_1000_1011
1116_1000_0011
1216_1000_0111
1316_1000_0011
1416_1000_1110
1516_0000_0000
1616_1000_0101
1716_1000_1110
0117_1000_1101
0217_1000_1110
0317_0000_0000
0417_1000_1100
0517_0000_0000
0617_1000_1100
0717_1000_1100
0817_0000_0000
0917_0000_0000
1017_0000_0000
1117_0000_0000
1217_1000_1100
1317_0000_0000
1417_1000_1100
1517_0000_0000
1617_1000_1101
1717_1000_1110
0118_1000_1101
0218_1000_1011
0318_1000_0011
0418_1000_1010
0518_0000_0000
0618_1000_1001
0718_1000_0011
0818_1000_0110
0918_0000_0000
1018_1000_0101
1118_1000_0011
1218_1000_1010
1318_0000_0000
1418_1000_1001
1518_1000_0011
1618_1000_1011
1718_1000_1110
0119_1000_1100
0219_0000_0000
0319_0000_0000
0419_0000_0000
0519_0000_0000
0619_0000_0000
0719_0000_0000
0819_1000_1100
0919_0000_0000
1019_1000_1100
1119_0000_0000
1219_0000_0000
1319_0000_0000
1419_0000_0000
1519_0000_0000
1619_0000_0000
1719_1000_1100
0120_1000_1001
0220_1000_0011
0320_1000_0011
0420_1000_0011
0520_1000_0011
0620_1000_0011
0720_1000_0011
0820_1000_1011
0920_1000_0011
1020_1000_1011
1120_1000_0011
1220_1000_0011
1320_1000_0011
1420_1000_0011
1520_1000_0011
1620_1000_0011
1720_1000_1010