[x][x][y][y]_[dot][tpaper][vac][cov]_[u][d][l][r] 17*20
0101_100_0101
0201_100_0011
0301_100_0011
0401_100_0111
0501_100_0011
0601_100_0011
0701_100_0011
0801_100_0110
0901_000_0000
1001_100_0101
1101_100_0011
1201_100_0011
1301_100_0011
1401_100_0111
1501_100_0011
1601_100_0011
1701_100_0110
0102_001_1100
0202_000_0000
0302_000_0000
0402_100_1100
0502_000_0000
0602_000_0000
0702_000_0000
0802_100_1100
0902_000_0000
1002_100_1100
1102_000_0000
1202_000_0000
1302_000_0000
1402_100_1100
1502_000_0000
1602_000_0000
1702_001_1100
0103_100_1100
0203_000_0000
0303_000_0000
0403_100_1100
0503_000_0000
0603_000_0000
0703_000_0000
0803_100_1100
0903_000_0000
1003_100_1100
1103_000_0000
1203_000_0000
1303_000_0000
1403_100_1100
1503_000_0000
1603_000_0000
1703_100_1100
0104_100_1101
0204_100_0011
0304_100_0011
0404_100_1111
0504_100_0011
0604_100_0111
0704_100_0011
0804_100_1011
0904_100_0011
1004_100_1011
1104_100_0011
1204_100_0111
1304_100_0011
1404_100_1111
1504_100_0011
1604_100_0011
1704_100_1110
0105_100_1100
0205_000_0000
0305_000_0000
0405_100_1100
0505_000_0000
0605_100_1100
0705_000_0000
0805_000_0000
0905_000_0000
1005_000_0000
1105_000_0000
1205_100_1100
1305_000_0000
1405_100_1100
1505_000_0000
1605_000_0000
1705_100_1100
0106_100_1001
0206_100_0011
0306_100_0011
0406_100_1110
0506_000_0000
0606_100_1001
0706_100_0011
0806_100_0110
0906_000_0000
1006_100_0101
1106_100_0011
1206_100_1010
1306_000_0000
1406_100_1101
1506_100_0011
1606_100_0011
1706_100_1010
0107_000_0000
0207_000_0000
0307_000_0000
0407_100_1100
0507_000_0000
0607_000_0000
0707_000_0000
0807_100_1100
0907_000_0000
1007_100_1100
1107_000_0000
1207_000_0000
1307_000_0000
1407_100_1100
1507_000_0000
1607_000_0000
1707_000_0000
0108_000_0000
0208_000_0000
0308_000_0000
0408_100_1100
0508_000_0000
0608_100_0101
0708_100_0011
0808_100_1011
0908_100_0011
1008_100_1011
1108_100_0011
1208_100_0110
1308_000_0000
1408_100_1100
1508_000_0000
1608_000_0000
1708_000_0000
0109_000_0000
0209_000_0000
0309_000_0000
0409_100_1100
0509_000_0000
0609_100_1100
0709_000_0000
0809_000_0000
0909_000_0000
1009_000_0000
1109_000_0000
1209_100_1100
1309_000_0000
1409_100_1100
1509_000_0000
1609_000_0000
1709_000_0000
0110_000_0000
0210_000_0000
0310_000_0000 !!!
0410_100_1111
0510_100_0011
0610_100_1110
0710_000_0000
0810_000_0000
0910_000_0000
1010_000_0000
1110_000_0000
1210_100_1101
1310_100_0011
1410_100_1111
1510_000_0000 !!!
1610_000_0000
1710_000_0000
0111_000_0000
0211_000_0000
0311_000_0000
0411_100_1100
0511_000_0000
0611_100_1100
0711_000_0000
0811_000_0000
0911_000_0000
1011_000_0000
1111_000_0000
1211_100_1100
1311_000_0000
1411_100_1100
1511_000_0000
1611_000_0000
1711_000_0000
0112_000_0000
0212_000_0000
0312_000_0000
0412_100_1100
0512_000_0000
0612_100_1101
0712_100_0011
0812_100_0011
0912_100_0011
1012_100_0011
1112_100_0011
1212_100_1110
1312_000_0000
1412_100_1100
1512_000_0000
1612_000_0000
1712_000_0000
0113_000_0000
0213_000_0000
0313_000_0000
0413_100_1100
0513_000_0000
0613_100_1100
0713_000_0000
0813_000_0000
0913_000_0000
1013_000_0000
1113_000_0000
1213_100_1100
1313_000_0000
1413_100_1100
1513_000_0000
1613_000_0000
1713_000_0000
0114_100_0101
0214_100_0011
0314_100_0011
0414_100_1111
0514_100_0011
0614_100_1011
0714_100_0011
0814_100_0110
0914_000_0000
1014_100_0101
1114_100_0011
1214_100_1011
1314_100_0011
1414_100_1111
1514_100_0011
1614_100_0011
1714_100_0110
0115_100_1100
0215_000_0000
0315_000_0000
0415_100_1100
0515_000_0000
0615_000_0000
0715_000_0000
0815_100_1100
0915_000_0000
1015_100_1100
1115_000_0000
1215_000_0000
1315_000_0000
1415_100_1100
1515_000_0000
1615_000_0000
1715_100_1100
0116_100_1101
0216_100_0110
0316_000_0000
0416_100_1101
0516_100_0011
0616_100_0111
0716_100_0011
0816_100_1011
0916_100_0011
1016_100_1011
1116_100_0011
1216_100_0111
1316_100_0011
1416_100_1110
1516_000_0000
1616_100_0101
1716_100_1110
0117_100_1101
0217_100_1110
0317_000_0000
0417_100_1100
0517_000_0000
0617_100_1100
0717_000_0000
0817_000_0000
0917_000_0000
1017_000_0000
1117_000_0000
1217_100_1100
1317_000_0000
1417_100_1100
1517_000_0000
1617_100_1101
1717_100_1110
0118_100_1101
0218_100_1011
0318_100_0011
0418_100_1010
0518_000_0000
0618_100_1001
0718_100_0011
0818_100_0110
0918_000_0000
1018_100_0101
1118_100_0011
1218_100_1010
1318_000_0000
1418_100_1001
1518_100_0011
1618_100_1011
1718_100_1110
0119_001_1100
0219_000_0000
0319_000_0000
0419_000_0000
0519_000_0000
0619_000_0000
0719_000_0000
0819_100_1100
0919_000_0000
1019_100_1100
1119_000_0000
1219_000_0000
1319_000_0000
1419_000_0000
1519_000_0000
1619_000_0000
1719_001_1100
0120_100_1001
0220_100_0011
0320_100_0011
0420_100_0011
0520_100_0011
0620_100_0011
0720_100_0011
0820_100_1011
0920_100_0011
1020_100_1011
1120_100_0011
1220_100_0011
1320_100_0011
1420_100_0011
1520_100_0011
1620_100_0011
1720_100_1010